
F 220,100,0
SO ./texture/wall2.png

EA ./texture/wall4.png
C    225,30,                    0


NO./texture/wall1.png
WE    ./texture/wall3.png





1111100
1000000
10111
10W01
10011
11111