NO ./texture/wall1.png
SO ./texture/wall2.png
WE ./texture/wall3.png
EA ./texture/wall4.png
F   255, 255,    0
C 0, 0,    255

111111111111111111111111
  1000000000000000000001
 100000000W0000000000001
  1000000000000000000001
111111111111111111111111