NO ./texture/wall1.png
SO ./texture/wall2.png
WE ./texture/wall3.png
EA ./texture/wall4.png
F 055,0,0
C 0,055,0


111111111111111111111111
1000000000000000000000W1
100010000000000000000001
100000000000000000000001
111111111111111111111111