NO ./texture/wall1.png
SO ./texture/wall2.png
WE ./texture/wall3.png
EA ./texture/wall4.png
C 225,255,255
F 225,255,255


1  111111111111111111111111111111
1       1000000000110000000000001
1       101100000111000000000001
1       1001000000000000000000001
111111111011000001110000000000001
100000000011000001110111111101111
11110111111111011100000010001
11110111111111011101010000001
1100100011010101110000001101
1000100000000000110000001111
10001000000000001101010010001
11000001110101011111011110N01
11110111 1110101 101111010001
1111111   11111   1111111111 