NO ./texture/wall1.png
SO ./texture/wall2.png
WE ./texture/wall3.png
EA ./texture/wall4.png
F   255, 255,    0
C 0, 0,    255

111111111111111111111111
  10000000000000000000001
  10000000W000000000000011111
  10000000000000000000011
111111111111111111111111